20010005
2002000A
54000000
20210014
54000000
AC010000
