20010005
20020011
2003FFFC
20041467
2005FFB2
20460003
28470003
30280009
34890009
742A0002
702B000A
644C0000
502D0001
584E0001
386FFFFC
