20010000
20020011
2003FFFC
08000004
200415B3
20070457
10000004
200715B3
200A15B3
14400004
200F0457
20140457
