20010005
2002000A
2003002F
54000000
28420009
30240009
