20190001
0334A029
00390820
03210820
00210820
00210820
00210820
0299A026
0BFFFFE4
