20010005
20020011
2003FFFC
0C000008
2005FFB2
200600FF
20041467
