20010005
20020011
2003FFFC
20041467
2005FFB2
AC010000
AC020001
AC430000
8C060000
8C070001
8C480000
