20010005
20020011
2003FFFC
20041467
2005FFB2
00223020
00233824
00854025
0041482D
0064502C
00225829
00416004
00A16806
00827022
00257826
