2001000A
28210001
20420001
AC220000
1420FFF0
