54000000
2001000A
20420001
28210001
1420FFF4
54000000
20030005
AC020001
20010005
