20010001
20020001
54000000
00221020
54000000
54000000
00221020
54000000
54000000
00221020
54000000
54000000
00220820
54000000
54000000
00221020
54000000
54000000
00220826
54000000
54000000
00411026
54000000
54000000
00220826
54000000
